+-+-+-+-+
|   |   |
+ + + + +
|b|   |c|
+-+-+-+-+
